3 5 6 7 8 9 10 11 12 13 14 15 16 17 18 19 
3 4 9 10 12 14 15 16 17 18 19 
3 4 9 10 11 14 15 16 17 18 19 
3 4 9 10 11 12 13 17 18 19 
3 4 9 10 11 12 13 16 18 
3 4 9 10 11 12 13 16 17 
3 4 6 7 9 12 15 16 17 18 19 
3 4 6 7 9 11 15 16 17 18 19 
3 4 6 7 9 11 12 13 14 17 18 19 
3 4 6 7 9 11 12 13 14 16 18 
3 4 6 7 9 11 12 13 14 16 17 
3 4 6 7 8 10 11 12 13 14 15 16 17 18 19 
2 5 7 10 11 12 13 14 15 16 17 18 19 
2 5 7 8 9 12 15 16 17 18 19 
2 5 7 8 9 11 15 16 17 18 19 
2 5 7 8 9 11 12 13 14 17 18 19 
2 5 7 8 9 11 12 13 14 16 18 
2 5 7 8 9 11 12 13 14 16 17 
2 5 6 11 12 13 15 16 17 18 19 
2 5 6 8 9 10 12 14 15 16 17 18 19 
2 5 6 8 9 10 11 14 15 16 17 18 19 
2 5 6 8 9 10 11 12 13 17 18 19 
2 5 6 8 9 10 11 12 13 16 18 
2 5 6 8 9 10 11 12 13 16 17 
2 4 7 9 10 11 12 13 14 15 16 17 18 19 
2 4 7 8 12 15 16 17 18 19 
2 4 7 8 11 15 16 17 18 19 
2 4 7 8 11 12 13 14 17 18 19 
2 4 7 8 11 12 13 14 16 18 
2 4 7 8 11 12 13 14 16 17 
2 4 6 9 12 14 17 18 19 
2 4 6 9 12 14 16 18 
2 4 6 9 12 14 16 17 
2 4 6 9 11 14 17 18 19 
2 4 6 9 11 14 16 18 
2 4 6 9 11 14 16 17 
2 4 6 9 11 12 13 15 16 17 18 19 
2 4 6 8 10 12 14 15 16 17 18 19 
2 4 6 8 10 11 14 15 16 17 18 19 
2 4 6 8 10 11 12 13 17 18 19 
2 4 6 8 10 11 12 13 16 18 
2 4 6 8 10 11 12 13 16 17 
1 7 9 10 11 12 13 14 15 16 17 18 19 
1 6 9 11 12 13 15 16 17 18 19 
1 4 5 7 10 11 12 13 14 15 16 17 18 19 
1 4 5 7 8 9 12 15 16 17 18 19 
1 4 5 7 8 9 11 15 16 17 18 19 
1 4 5 7 8 9 11 12 13 14 17 18 19 
1 4 5 7 8 9 11 12 13 14 16 18 
1 4 5 7 8 9 11 12 13 14 16 17 
1 4 5 6 11 12 13 15 16 17 18 19 
1 4 5 6 8 9 10 12 14 15 16 17 18 19 
1 4 5 6 8 9 10 11 14 15 16 17 18 19 
1 4 5 6 8 9 10 11 12 13 17 18 19 
1 4 5 6 8 9 10 11 12 13 16 18 
1 4 5 6 8 9 10 11 12 13 16 17 
1 2 3 9 10 12 14 15 16 17 18 19 
1 2 3 9 10 11 14 15 16 17 18 19 
1 2 3 9 10 11 12 13 17 18 19 
1 2 3 9 10 11 12 13 16 18 
1 2 3 9 10 11 12 13 16 17 
1 2 3 6 7 9 12 15 16 17 18 19 
1 2 3 6 7 9 11 15 16 17 18 19 
1 2 3 6 7 9 11 12 13 14 17 18 19 
1 2 3 6 7 9 11 12 13 14 16 18 
1 2 3 6 7 9 11 12 13 14 16 17 
1 2 3 6 7 8 10 11 12 13 14 15 16 17 18 19 
1 2 3 4 5 10 12 14 15 16 17 18 19 
1 2 3 4 5 10 11 14 15 16 17 18 19 
1 2 3 4 5 10 11 12 13 17 18 19 
1 2 3 4 5 10 11 12 13 16 18 
1 2 3 4 5 10 11 12 13 16 17 
1 2 3 4 5 8 9 12 14 17 18 19 
1 2 3 4 5 8 9 12 14 16 18 
1 2 3 4 5 8 9 12 14 16 17 
1 2 3 4 5 8 9 11 14 17 18 19 
1 2 3 4 5 8 9 11 14 16 18 
1 2 3 4 5 8 9 11 14 16 17 
1 2 3 4 5 8 9 11 12 13 15 16 17 18 19 
1 2 3 4 5 6 7 12 15 16 17 18 19 
1 2 3 4 5 6 7 11 15 16 17 18 19 
1 2 3 4 5 6 7 11 12 13 14 17 18 19 
1 2 3 4 5 6 7 11 12 13 14 16 18 
1 2 3 4 5 6 7 11 12 13 14 16 17 
1 2 3 4 5 6 7 8 9 10 13 14 15 16 17 18 19 
1 2 3 4 5 6 7 8 9 10 12 17 18 19 
1 2 3 4 5 6 7 8 9 10 12 16 18 
1 2 3 4 5 6 7 8 9 10 12 16 17 
1 2 3 4 5 6 7 8 9 10 11 17 18 19 
1 2 3 4 5 6 7 8 9 10 11 16 18 
1 2 3 4 5 6 7 8 9 10 11 16 17 
1 2 3 4 5 6 7 8 9 10 11 12 13 14 15 18 
1 2 3 4 5 6 7 8 9 10 11 12 13 14 15 17 
1 2 3 4 5 6 7 8 9 10 11 12 13 14 15 16 19 
